NO ./img/east.xpm
SO ./img/south.xpm
WE ./img/west.xpm
EA ./img/east.xpm

C 135,206,235
F 132,139,132

1111111111111111111111111
1000000011111111110000001
1011111011111111011111101
1000000000000000010000001
1011111011111111011110001
1011111011     1011110001
10000000111    1110000001
111111111111   111110N011
1000000011111  1110000001
101111101111111101111010111
100000000000000000000000001
111111111111111111111111111
11111111111111111
