NO ./img/north.xpm

WE ./img/west.xpm

EA ./img/east.xpm

SO ./img/south.xpm

C 135,206,235
F 132,139,132

111111111111111111111111111111
111111111000100000000000011111
100000000000000000111000100001
110000100000000000000000001111
100001111111000000000000111111
1111111000000000W0000000000001
110000000000000000000000000111
110000000000011110000000000011
100000000000111000000000000011
11000000000011100000000000111100
11000000000111100000000000011100
111111111111111111111111111111111
